AAAAAAAAAAAAAAAAAAAAAAAAAAAAAAAAAAAAAAAA
AAAAAAAAAAAAAAAAAAAAAAAAAAAAAAAAAAAAAAAA
AAAAAAAAAAAAAAAAAAAAAAAAAAAAAAAAAAAAAAAA
AAAAAAAAAAAEAAAAAEEAAAAAAAAAAAAAAAAAAAAA
AAAAAAAAAAEEEA#AEEEEAAAAAAAAAAAAAAAAAAAA
AAAAAAAA#EEEEEEEEEEEE#AAAAAAAAAAAAAAAAAA
AAAAEAAAEEEEEEEEEEEEEEAAAAAAAAAAAAAAAAAA
AAAEEAAEEEEEEEEEEEEEEEEAAAAAAAAAAAAAAAAA
AAEEEAEEEEEEEEEEEEEEEEEEAAAAAAAAAAAAAAAA
AEEEEEEEEEEEEEEEEEEEEEEEEAAAAAAAAAAAAAAA
WEEEEEEEEEEEEEEEEEEEEEEEEEWWWWWWWWWWWWWW