AAAAAAAAAAAAAAAAAAAAAAAAAAAAAAAAAAAAAAAA
AAAAAAAAAAAAAAAAAAAAAAAAAAAAAAAAAAAAAAAA
AAAAAAAAAAAAAAAAAAAAAAAAAAAAAAAAAAAAAAAA
AAAAAAAAAAAE##AAAEEAAAAAAAAAAAAAAAAAAAAA
AAAAAAAAAAEEE#AAEEEEAAAAAAAAAAAAAAAAAAAA
AAAAAAAAAEEEEEEEEEEEEAAAAAAAAAAAAAAAAAAA
AAAAEAAAEEEEEEEEEEEEEEAAAAAAAAAAAAAAAAAA
AAAEEAAEEEEEEEEEEEEEEEEAAAAAAAAAAAAAAAAA
AAEEEAEEEEEEEEEEEEEEEEEEAAAAAAAAAAAAAAAA
AEEEEEEEEEEEEEEEEEEEEEEEEAAAAAAAAAAAAAAA
WEEEEEEEEEEEEEEEEEEEEEEEEEWWWWWWWWWWWWWW